
6 6
WWWWWW
WEEPEW
WBWWWW
WEWWWW
WeWWWW
WWWWWW

6 6
WWWWWW
WPEEWW
WeBbEW
WEEWEW
WEEEEW
WWWWWW

7 8
WWWWWWWW
WWEeBPWW
WWEbBBEW
WEeEEEEW
WEWEWEEW
WEEeWWWW
WWWWWWWW

9 8
WWWWWWWW
WWWEEEWW
WePBEEWW
WWWEBeWW
WeWWBEWW
WEWEeEWW
WBEbBBeW
WEEEeEEW
WWWWWWWW

11 22
EEEEWWWWWEEEEEEEEEEEEE
EEEEWEEEWEEEEEEEEEEEEE
EEEEWBEEWEEEEEEEEEEEEE
EEWWWEEBWWWEEEEEEEEEEE
EEWEEBEEBEWEEEEEEEEEEE
WWWEWEWWWEWEEEEEWWWWWW
WEEEWEWWWEWWWWWWWEEeeW
WEBEEBEEEEEEEEEEEEEeeW
WWWWWEWWWWEWPWWWWEEeeW
EEEEWEEEEEEWWWEEWWWWWW
EEEEWWWWWWWWEEEEEEEEEE